{
  "id": "room_mage_missiles",
  "name": "mage_missiles",
  "layout": [
    "###############",
    "#.............#",
    "#..#.....#....#",
    "#.............#",
    "#.....#.....#.#",
    "#.............#",
    "#..#.....#....#",
    "#.............#",
    "#.....#.....#.#",
    "#.............#",
    "#..#.....#....#",
    "#.............#",
    "#...........#.#",
    "#.............#",
    "###############"
  ],
  "spawnPoints": [
    {
      "x": 3.9,
      "y": 3.1,
      "enemyType": "mage_missile"
    },
    {
      "x": 10.2,
      "y": 3.1,
      "enemyType": "mage_missile"
    }
  ],
  "friendlySpawnPoints": [],
  "obstacles": []
}