{
  "id": "room_it_aoe",
  "name": "it_AOE",
  "layout": [
    "###############",
    "#.............#",
    "#.............#",
    "#.............#",
    "#.............#",
    "#.............#",
    "#.............#",
    "#.............#",
    "#.............#",
    "#.............#",
    "#.............#",
    "#.............#",
    "#.............#",
    "#.............#",
    "###############"
  ],
  "spawnPoints": [
    {
      "x": 7,
      "y": 3.1,
      "enemyType": "artificer"
    }
  ],
  "friendlySpawnPoints": [],
  "obstacles": []
}