{
  "id": "room_the_bull_and_the_sniper",
  "name": "the_bull_and_the sniper",
  "layout": [
    "###############",
    "#.............#",
    "#.............#",
    "#.........#...#",
    "#.............#",
    "#...^^......#.#",
    "#..^^^........#",
    "#..^^^........#",
    "#.............#",
    "#.............#",
    "#.............#",
    "#.............#",
    "#.............#",
    "#.............#",
    "###############"
  ],
  "spawnPoints": [
    {
      "x": 3,
      "y": 5.1,
      "enemyType": "bull"
    },
    {
      "x": 10.9,
      "y": 4.1,
      "enemyType": "turret"
    }
  ],
  "friendlySpawnPoints": [],
  "obstacles": []
}