{
  "id": "room_it_pongs",
  "name": "it_pongs",
  "layout": [
    "###############",
    "#.............#",
    "#...##...##...#",
    "#..#..#.#..#..#",
    "#..#..#.#..#..#",
    "#..#..#.#..#..#",
    "#..#..#.#..#..#",
    "#..#..#.#..#..#",
    "#.............#",
    "#.............#",
    "#.............#",
    "#.............#",
    "#.............#",
    "#.............#",
    "###############"
  ],
  "spawnPoints": [
    {
      "x": 4,
      "y": 3.1,
      "enemyType": "pong"
    },
    {
      "x": 9.9,
      "y": 3.1,
      "enemyType": "pong"
    }
  ],
  "friendlySpawnPoints": [],
  "obstacles": []
}