{
  "id": "room_they_jump",
  "name": "they_jump",
  "layout": [
    "###############",
    "#.............#",
    "#.............#",
    "#.............#",
    "#.....###.....#",
    "#.............#",
    "#.............#",
    "#..#.......#..#",
    "#......#......#",
    "#.............#",
    "#.............#",
    "#.............#",
    "#.............#",
    "#.............#",
    "###############"
  ],
  "spawnPoints": [
    {
      "x": 3.1,
      "y": 3,
      "enemyType": "jumper"
    },
    {
      "x": 10.8,
      "y": 3.1,
      "enemyType": "jumper"
    }
  ],
  "friendlySpawnPoints": [],
  "obstacles": []
}