{
  "id": "room_it_shoots",
  "name": "it_shoots",
  "layout": [
    "###############",
    "#.............#",
    "#.............#",
    "#..#.......#..#",
    "#.............#",
    "#....#...#....#",
    "#.............#",
    "#.............#",
    "#.............#",
    "#.............#",
    "#.............#",
    "#.............#",
    "#.............#",
    "#.............#",
    "###############"
  ],
  "spawnPoints": [
    {
      "x": 7,
      "y": 4.1,
      "enemyType": "mage_missile"
    }
  ],
  "friendlySpawnPoints": [],
  "obstacles": []
}