{
  "id": "room_it_camps",
  "name": "it_camps",
  "layout": [
    "###############",
    "#.............#",
    "#.............#",
    "#..P.P...P.P..#",
    "#..PPP...PPP..#",
    "#.#.........#.#",
    "##...........##",
    "#.............#",
    "#.............#",
    "#.............#",
    "#.............#",
    "#.............#",
    "#.............#",
    "#.............#",
    "###############"
  ],
  "spawnPoints": [
    {
      "x": 4.1,
      "y": 3,
      "enemyType": "turret"
    },
    {
      "x": 10,
      "y": 3.1,
      "enemyType": "turret"
    }
  ],
  "friendlySpawnPoints": [],
  "obstacles": []
}