{
  "id": "room_cone_hell",
  "name": "cone_hell",
  "layout": [
    "###############",
    "#.............#",
    "#.............#",
    "#.............#",
    "#....#...#....#",
    "#...#.....#...#",
    "#..#.......#..#",
    "#.............#",
    "#..#.......#..#",
    "#...#.....#...#",
    "#....#...#....#",
    "#.............#",
    "#.............#",
    "#.............#",
    "###############"
  ],
  "spawnPoints": [
    {
      "x": 11,
      "y": 7,
      "enemyType": "bullet_hell"
    },
    {
      "x": 3,
      "y": 7,
      "enemyType": "bullet_hell"
    }
  ],
  "friendlySpawnPoints": [],
  "obstacles": []
}