{
  "id": "room_bulls",
  "name": "bulls",
  "layout": [
    "###############",
    "#.............#",
    "#.............#",
    "#.............#",
    "#.............#",
    "#.............#",
    "#.............#",
    "#.............#",
    "#.............#",
    "#.............#",
    "#...#..#..#...#",
    "#.............#",
    "#.............#",
    "#.............#",
    "###############"
  ],
  "spawnPoints": [
    {
      "x": 4,
      "y": 7.1,
      "enemyType": "bull"
    },
    {
      "x": 6.9,
      "y": 4,
      "enemyType": "bull"
    },
    {
      "x": 10,
      "y": 7.1,
      "enemyType": "bull"
    }
  ],
  "friendlySpawnPoints": [],
  "obstacles": []
}