{
  "id": "room_custom",
  "name": "Custom Room",
  "layout": [
    "##########",
    "#........#",
    "#.#......#",
    "#........#",
    "#........#",
    "#........#",
    "#........#",
    "#........#",
    "#........#",
    "##########"
  ],
  "spawnPoints": [],
  "obstacles": []
}