{
  "id": "room_corrida_boss",
  "name": "corrida boss",
  "layout": [
    "###############",
    "#.............#",
    "#.#...###...#.#",
    "#.............#",
    "#.............#",
    "#...#.....#...#",
    "#.#.........#.#",
    "#.............#",
    "#.#.........#.#",
    "#...#.....#...#",
    "#.............#",
    "#.............#",
    "#.#...###...#.#",
    "#.............#",
    "###############"
  ],
  "spawnPoints": [
    {
      "x": 7.2,
      "y": 6.9,
      "enemyType": "bull_boss"
    }
  ],
  "friendlySpawnPoints": [],
  "obstacles": []
}
