{
  "id": "room_custom",
  "name": "Custom Room",
  "layout": [
    "###############",
    "#.............#",
    "#.PPP.........#",
    "#.P.P.........#",
    "#.PPP.........#",
    "#.............#",
    "#.............#",
    "#.............#",
    "#.............#",
    "#.............#",
    "#.............#",
    "#.............#",
    "#.............#",
    "#.............#",
    "###############"
  ],
  "spawnPoints": [
    {
      "x": 3,
      "y": 11,
      "enemyType": "dummy_tank"
    }
  ],
  "friendlySpawnPoints": [],
  "obstacles": []
}