{
  "id": "room_04",
  "name": "Pattern Core Test",
  "roomType": "boss",
  "layout": [
    "#############",
    "#...........#",
    "#...........#",
    "#...........#",
    "#...........#",
    "#...........#",
    "#...........#",
    "#...........#",
    "#...........#",
    "#...........#",
    "#############"
  ],
  "spawnPoints": [
    {
      "x": 6,
      "y": 5,
      "enemyType": "laser_pattern_boss"
    }
  ],
  "obstacles": []
}
