{
  "id": "room_test_voicelines",
  "name": "Test Voicelines",
  "layout": [
    "#############",
    "#...........#",
    "#...........#",
    "#...........#",
    "#...........#",
    "#.....M.....#",
    "#...........#",
    "#...........#",
    "#...........#",
    "#...........#",
    "#############"
  ],
  "spawnPoints": [
    {
      "x": 1,
      "y": 1,
      "enemyType": "dummy_tank"
    }
  ],
  "obstacles": []
}
