{
  "id": "room_test_bull",
  "name": "Bull Test",
  "layout": [
    "#############",
    "#....V......#",
    "#....V......#",
    "#....V......#",
    "#....V......#",
    "#....V......#",
    "#....V......#",
    "#....V......#",
    "#....V......#",
    "#...........#",
    "#############"
  ],
  "spawnPoints": [
    {
      "x": 9,
      "y": 5,
      "enemyType": "bull"
    }
  ],
  "obstacles": []
}
