{
  "id": "room_tutorial_base",
  "name": "Tutorial Phase Room",
  "layout": [
    "###############",
    "#.............#",
    "#.............#",
    "#.............#",
    "#...VV...PP...#",
    "#...VV...PP...#",
    "#...VV...PP...#",
    "#...VV...PP...#",
    "#...VV...PP...#",
    "#...VV...PP...#",
    "#.............#",
    "#.............#",
    "#.............#",
    "###############"
  ],
  "spawnPoints": [],
  "obstacles": []
}
