{
  "id": "room_test_tiles_maze",
  "name": "Tile Maze Test",
  "layout": [
    "#############",
    "#...........#",
    "#.#####.#####",
    "#.#...#.....#",
    "#.#.^.#.VV..#",
    "#.#...#..P..#",
    "#.#####..P..#",
    "#.....#.....#",
    "#..V..#..^..#",
    "#.....M.....#",
    "#############"
  ],
  "spawnPoints": [
    {
      "x": 6,
      "y": 5,
      "enemyType": "dummy_tank"
    }
  ],
  "obstacles": []
}
