{
  "id": "room_tutorial_02",
  "name": "tutorial_02",
  "layout": [
    "###############",
    "#.............#",
    "#.^.^.....^.^.#",
    "#..^.......^..#",
    "#.^.^.....^.^.#",
    "#.............#",
    "#####.....#####",
    "#####.....#####",
    "#.............#",
    "#.PP.......PP.#",
    "#.PPP.....PPP.#",
    "#.PPP.....PPP.#",
    "#.PP.......PP.#",
    "#.............#",
    "###############"
  ],
  "spawnPoints": [],
  "friendlySpawnPoints": [],
  "obstacles": []
}